a√±o,NCODI,Urg_altas,Urg_ingresos,Urg_traslados,Urg_exitus,Urg_total
2017,4.8600000000000000e+02,9519,787,24,0,10330
2017,5.9500000000000000e+02,27283,5197,345,40,32865
2017,4.3300000000000000e+02,11405,1116,569,5,13095
2017,1.0580000000000000e+03,2027,367,210,4,2608
2017,2.6100000000000000e+02,18737,1102,423,1,20263
2017,7.3000000000000000e+02,61662,5136,1203,60,68061
2017,5.7700000000000000e+02,36508,6724,840,53,44125
2017,7.8800000000000000e+02,129577,16944,1955,76,148552
2017,8.6500000000000000e+02,55259,2824,857,76,59016
2017,9.7900000000000000e+02,16328,491,1235,5,18059
2017,9.9800000000000000e+02,19357,197,1265,5,20824
2017,1.0720000000000000e+03,35102,445,2194,21,37762
2017,2.2100000000000000e+02,5461,1093,93,0,6647
2017,5.0600000000000000e+02,27803,756,307,1,28867
2017,7.2700000000000000e+02,46849,9503,466,62,56880
2017,3.5500000000000000e+02,973,16,11,0,1000
2017,4.8700000000000000e+02,2278,278,54,0,2610
2017,9.3800000000000000e+02,108569,20901,4569,132,134171
2017,8.8600000000000000e+02,3248,1788,12,0,5048
2017,8.3500000000000000e+02,4563,110,0,0,4673
2017,9.9900000000000000e+02,0,0,0,0,0
2017,7.9800000000000000e+02,75630,14894,2983,166,93673
2017,5.0400000000000000e+02,3436,1246,88,0,4770
2017,2.4700000000000000e+02,23163,1480,75,0,24718
2017,2.1600000000000000e+02,20632,1153,37,0,21822
2017,6.5400000000000000e+02,10853,1040,11,5,11909
2017,6.5000000000000000e+01,0,0,0,0,0
2017,4.7200000000000000e+02,14479,1153,369,7,16008
2017,4.2700000000000000e+02,0,0,0,0,0
2017,4.9100000000000000e+02,7372,1196,284,11,8863
2017,5.5100000000000000e+02,13433,563,133,3,14132
2017,1.0600000000000000e+02,0,0,0,0,0
2017,8.1900000000000000e+02,0,0,0,0,0
2017,8.3600000000000000e+02,0,0,0,0,0
2017,9.1500000000000000e+02,0,0,0,0,0
2017,9.4200000000000000e+02,0,0,0,0,0
2017,1.1400000000000000e+03,0,0,0,0,0
2017,7.4800000000000000e+02,86179,18451,95,81,104806
2017,1.9800000000000000e+02,0,0,0,0,0
2017,8.7100000000000000e+02,18228,2811,735,7,21781
2017,9.4800000000000000e+02,29828,1008,43,0,30879
2017,1.0510000000000000e+03,0,0,0,0,0
2017,1.0830000000000000e+03,0,0,0,0,0
2017,1.0960000000000000e+03,0,0,0,0,0
2017,6.7900000000000000e+02,82208,15346,186,113,97853
2017,1.7600000000000000e+02,10319,414,68,0,10801
2017,5.3700000000000000e+02,10949,533,282,3,11767
2017,6.0800000000000000e+02,19413,3818,292,109,23632
2017,5.9600000000000000e+02,11404,3479,448,64,15395
2017,7.4900000000000000e+02,131935,17458,895,216,150504
2017,7.5800000000000000e+02,226566,27612,1095,234,255507
2017,1.1040000000000000e+03,110198,20373,942,103,131616
2017,5.6700000000000000e+02,27,0,11,0,38
2017,6.7700000000000000e+02,88296,10151,700,82,99229
2017,6.7000000000000000e+02,64802,3172,165,1,68140
2017,5.8800000000000000e+02,0,0,0,0,0
2017,7.5300000000000000e+02,217857,32586,831,205,251479
2017,8.8700000000000000e+02,139,843,48,0,1030
2017,1.1300000000000000e+02,0,0,0,0,0
2017,6.1900000000000000e+02,17522,506,20,0,18048
2017,1.6300000000000000e+02,5194,69,1,0,5264
2017,1.3100000000000000e+02,0,0,0,0,0
2017,3.7500000000000000e+02,354,0,79,0,433
2017,1.0900000000000000e+03,146165,20838,2049,43,169095
2017,7.6400000000000000e+02,136866,16903,548,102,154419
2017,1.4000000000000000e+01,20891,126,57,0,21074
2017,6.5700000000000000e+02,32934,3317,355,32,36638
2017,3.6200000000000000e+02,22110,686,160,1,22957
2017,9.8900000000000000e+02,23557,2178,444,22,26201
2017,9.9000000000000000e+02,32099,3679,717,43,36538
2017,6.8000000000000000e+02,139184,18574,2013,81,159852
2017,4.1100000000000000e+02,43346,2693,69,5,46113
2017,2.4100000000000000e+02,29227,2410,27,1,31665
2017,5.5800000000000000e+02,41510,8156,337,57,50060
2017,1.6700000000000000e+02,3864,65,5,0,3934
2017,2.4800000000000000e+02,11617,3288,191,0,15096
2017,2.2400000000000000e+02,23797,1058,42,3,24900
2017,5.9100000000000000e+02,72368,11776,502,63,84709
2017,5.8600000000000000e+02,74170,13584,1369,75,89198
2017,4.5300000000000000e+02,922,40,0,0,962
2017,1.4500000000000000e+02,0,0,0,0,0
2017,5.1100000000000000e+02,70231,11934,665,74,82904
2017,5.3000000000000000e+02,65739,12176,416,61,78392
2017,6.0000000000000000e+00,25817,1125,20,0,26962
2017,1.6100000000000000e+02,0,0,0,0,0
2017,6.2300000000000000e+02,76630,13119,774,57,90580
2017,3.4900000000000000e+02,687,312,56,0,1055
2017,8.7500000000000000e+02,31378,3565,30,0,34973
2017,9.4600000000000000e+02,32447,6521,140,9,39117
2017,1.0230000000000000e+03,68695,12252,202,105,81254
2017,1.0540000000000000e+03,49219,9039,329,63,58650
2017,1.0570000000000000e+03,0,0,0,0,0
2017,1.0310000000000000e+03,0,0,0,0,0
2017,1.0320000000000000e+03,80041,9158,254,60,89513
2017,1.0640000000000000e+03,36679,2646,239,0,39564
2017,2.2600000000000000e+02,43081,2305,52,0,45438
2017,6.8700000000000000e+02,56996,5426,836,79,63337
2017,7.4500000000000000e+02,140414,16117,1175,104,157810
2017,1.0900000000000000e+02,40916,2901,18,0,43835
2017,8.0800000000000000e+02,139439,10593,1055,83,151170
2017,9.7100000000000000e+02,73434,548,2741,7,76730
2017,1.2800000000000000e+02,10694,485,0,0,11179
2017,9.1900000000000000e+02,33775,9718,343,47,43883
2017,7.2500000000000000e+02,126095,19328,0,89,145512
2017,3.0000000000000000e+00,0,0,0,0,0
2017,3.0600000000000000e+02,0,0,0,0,0
2017,1.5000000000000000e+01,7873,16,12,0,7901
2017,2.6400000000000000e+02,31829,2289,95,5,34218
2017,8.6700000000000000e+02,8905,0,0,0,8905
2017,9.1000000000000000e+02,34316,6376,563,56,41311
2017,1.0530000000000000e+03,54235,10700,1110,76,66121
2017,1.0550000000000000e+03,64362,12046,1797,87,78292
2017,1.0810000000000000e+03,0,0,0,0,0
2017,1.0990000000000000e+03,2613,30,0,0,2643
2017,1.1150000000000000e+03,0,0,0,0,0
2017,5.2900000000000000e+02,0,0,0,0,0
2017,3.4500000000000000e+02,0,0,0,0,0
2017,5.1500000000000000e+02,13705,520,0,0,14225
2017,1.7400000000000000e+02,0,0,0,0,0
2017,5.2300000000000000e+02,0,0,0,0,0
2017,6.9700000000000000e+02,83921,6274,306,7,90508
2017,2.3900000000000000e+02,38345,4908,278,1,43532
2017,2.8700000000000000e+02,54744,5641,105,175,60665
2017,3.7700000000000000e+02,0,0,0,0,0
2017,6.9200000000000000e+02,46684,6991,86,31,53792
2017,4.3500000000000000e+02,22403,1449,72,8,23932
2017,4.2300000000000000e+02,10932,1411,0,0,12343
2017,3.5100000000000000e+02,16781,3132,267,8,20188
2017,8.1000000000000000e+02,9100,1204,0,0,10304
2017,8.3000000000000000e+02,63381,9243,513,45,73182
2017,8.9200000000000000e+02,91850,12750,528,118,105246
2017,9.2100000000000000e+02,86187,7924,189,2,94302
2017,9.9100000000000000e+02,17633,224,263,2,18122
2017,9.9200000000000000e+02,56799,5834,517,75,63225
2017,9.9300000000000000e+02,22452,4145,77,9,26683
2017,1.0700000000000000e+03,130276,18498,626,138,149538
2017,1.0950000000000000e+03,19701,1918,339,2,21960
2017,1.0940000000000000e+03,6457,339,32,4,6832
2017,1.1240000000000000e+03,0,0,0,0,0
2017,4.7300000000000000e+02,31007,3274,24,0,34305
2017,6.6300000000000000e+02,108435,11815,5424,203,125877
2017,5.5200000000000000e+02,2867,6,1,0,2874
2017,7.7200000000000000e+02,84548,15013,3949,397,103907
2017,5.6800000000000000e+02,5542,312,0,0,5854
2017,3.9800000000000000e+02,7412,1100,5,0,8517
2017,3.9400000000000000e+02,5265,402,7,0,5674
2017,6.1400000000000000e+02,0,0,0,0,0
2017,2.3500000000000000e+02,2851,15,0,0,2866
2017,6.1600000000000000e+02,45168,1631,2180,11,48990
2017,2.6700000000000000e+02,21960,3745,62,3,25770
2017,5.6500000000000000e+02,0,0,0,0,0
2017,2.2000000000000000e+02,21116,1506,46,2,22670
2017,2.7800000000000000e+02,18937,1909,33,0,20879
2017,1.0700000000000000e+02,0,0,0,0,0
2017,7.1100000000000000e+02,119702,22414,7510,170,149796
2017,2.0400000000000000e+02,55,0,0,0,55
2017,5.7900000000000000e+02,88513,1491,24,0,90028
2017,3.4800000000000000e+02,0,0,0,0,0
2017,7.6600000000000000e+02,15058,1101,239,2,16400
2017,7.6100000000000000e+02,0,0,0,0,0
2017,7.2800000000000000e+02,38089,7231,195,16,45531
2017,2.8000000000000000e+02,46926,3661,117,3,50707
2017,2.2200000000000000e+02,2159,58,0,0,2217
2017,2.7600000000000000e+02,79082,4785,276,0,84143
2017,1.1000000000000000e+01,12804,3204,35,4,16047
2017,3.0200000000000000e+02,31414,533,103,0,32050
2017,6.8200000000000000e+02,17104,2001,202,13,19320
2017,2.7900000000000000e+02,86378,5584,339,1,92302
2017,2.8200000000000000e+02,82182,6411,119,0,88712
2017,2.8100000000000000e+02,42994,6935,80,32,50041
2017,1.8300000000000000e+02,1073,25,0,0,1098
2017,6.1000000000000000e+02,13709,40,0,0,13749
2017,1.1600000000000000e+02,0,0,0,0,0
2017,1.1500000000000000e+02,0,0,0,0,0
2017,1.1400000000000000e+02,0,0,0,0,0
2017,1.1900000000000000e+02,46,17,0,0,63
2017,7.7000000000000000e+02,114003,13289,2069,149,129510
2017,5.8300000000000000e+02,50461,2539,664,21,53685
2017,1.3600000000000000e+02,0,0,0,0,0
2017,4.6900000000000000e+02,27402,2309,139,10,29860
2017,6.4200000000000000e+02,43432,7415,831,67,51745
2017,6.7400000000000000e+02,130655,9954,103,2,140714
2017,1.9300000000000000e+02,0,0,0,0,0
2017,5.2600000000000000e+02,101573,10970,450,36,113029
2017,6.9800000000000000e+02,93153,13933,3949,280,111315
2017,6.3000000000000000e+02,54713,3975,784,17,59489
2017,1.2400000000000000e+02,0,0,0,0,0
2017,3.6400000000000000e+02,0,0,0,0,0
2017,4.3900000000000000e+02,34897,1323,437,0,36657
2017,5.7000000000000000e+02,93554,13076,2700,23,109353
2017,1.2300000000000000e+02,0,0,0,0,0
2017,3.1000000000000000e+02,2056,1168,0,0,3224
2017,5.7100000000000000e+02,49615,4653,952,69,55289
2017,2.9600000000000000e+02,5193,0,0,0,5193
2017,5.6600000000000000e+02,64241,4975,1255,47,70518
2017,7.8400000000000000e+02,122640,15419,3234,364,141657
2017,1.0200000000000000e+02,0,0,0,0,0
2017,3.7900000000000000e+02,0,0,0,0,0
2017,6.3900000000000000e+02,80824,7761,1331,21,89937
2017,4.5700000000000000e+02,26200,1518,334,16,28068
2017,6.0900000000000000e+02,119895,9636,83,3,129617
2017,1.0100000000000000e+02,0,0,0,0,0
2017,4.5400000000000000e+02,49249,7167,292,12,56720
2017,3.1800000000000000e+02,3112,809,163,0,4084
2017,6.0000000000000000e+02,57669,5627,545,4,63845
2017,5.4500000000000000e+02,104662,9367,502,146,114677
2017,1.0000000000000000e+02,0,0,0,0,0
2017,7.0200000000000000e+02,108807,10737,1672,106,121322
2017,7.7800000000000000e+02,52131,8833,546,43,61553
2017,3.4100000000000000e+02,6088,167,53,0,6308
2017,9.9000000000000000e+01,0,0,0,0,0
2017,7.6700000000000000e+02,40950,5496,1491,53,47990
2017,3.5900000000000000e+02,43027,46,1168,1,44242
2017,9.8000000000000000e+01,0,0,0,0,0
2017,1.3200000000000000e+02,0,0,0,0,0
2017,9.7000000000000000e+01,0,0,0,0,0
2017,1.0300000000000000e+02,0,0,0,0,0
2017,1.1000000000000000e+02,0,0,0,0,0
2017,9.4000000000000000e+01,0,0,0,0,0
2017,9.1000000000000000e+01,0,0,0,0,0
2017,6.6400000000000000e+02,101307,11399,1061,120,113887
2017,9.1800000000000000e+02,167162,30301,3560,321,201344
2017,9.2000000000000000e+01,0,0,0,0,0
2017,9.5000000000000000e+01,0,0,0,0,0
2017,3.0100000000000000e+02,18364,0,65,0,18429
2017,4.9200000000000000e+02,47046,3826,967,23,51862
2017,8.1100000000000000e+02,10362,1289,16,1,11668
2017,8.1200000000000000e+02,0,0,0,0,0
2017,8.3200000000000000e+02,0,0,0,0,0
2017,8.4100000000000000e+02,0,0,0,0,0
2017,8.5600000000000000e+02,0,0,0,0,0
2017,8.5900000000000000e+02,0,0,0,0,0
2017,8.6100000000000000e+02,0,0,0,0,0
2017,8.8000000000000000e+02,0,0,0,0,0
2017,8.8300000000000000e+02,0,0,0,0,0
2017,8.8400000000000000e+02,0,0,0,0,0
2017,8.7700000000000000e+02,0,0,0,0,0
2017,9.1100000000000000e+02,0,0,0,0,0
2017,9.1300000000000000e+02,1967,271,115,0,2353
2017,9.2200000000000000e+02,44037,1373,0,1,45411
2017,9.2300000000000000e+02,0,0,0,0,0
2017,9.2400000000000000e+02,0,0,0,0,0
2017,9.4700000000000000e+02,0,0,0,0,0
2017,9.5100000000000000e+02,0,0,0,0,0
2017,1.1030000000000000e+03,0,0,0,0,0
2017,9.7200000000000000e+02,0,0,0,0,0
2017,9.7300000000000000e+02,10081,102,2,0,10185
2017,9.7400000000000000e+02,0,0,0,0,0
2017,9.7500000000000000e+02,0,0,0,0,0
2017,9.6000000000000000e+02,0,0,0,0,0
2017,1.0280000000000000e+03,0,0,0,0,0
2017,9.7600000000000000e+02,0,0,0,0,0
2017,9.7700000000000000e+02,0,0,0,0,0
2017,1.0200000000000000e+03,0,0,0,0,0
2017,9.9400000000000000e+02,54152,6693,683,16,61544
2017,9.9500000000000000e+02,0,0,0,0,0
2017,1.0600000000000000e+03,340,265,62,0,667
2017,1.0050000000000000e+03,0,0,0,0,0
2017,1.0610000000000000e+03,0,0,0,0,0
2017,1.0620000000000000e+03,0,0,0,0,0
2017,1.0060000000000000e+03,0,0,0,0,0
2017,1.0880000000000000e+03,0,0,0,0,0
2017,1.0890000000000000e+03,47812,1343,114,2,49271
2017,1.0760000000000000e+03,0,0,0,0,0
2017,1.0780000000000000e+03,0,0,0,0,0
2017,1.0330000000000000e+03,56788,8699,2034,124,67645
2017,1.0370000000000000e+03,0,0,0,0,0
2017,1.0390000000000000e+03,0,0,0,0,0
2017,1.0670000000000000e+03,0,0,0,0,0
2017,1.0650000000000000e+03,0,0,0,0,0
2017,1.0660000000000000e+03,33266,1953,47,0,35266
2017,1.1000000000000000e+03,0,0,0,0,0
2017,1.1050000000000000e+03,0,0,0,0,0
2017,1.1070000000000000e+03,0,0,0,0,0
2017,1.1110000000000000e+03,0,0,0,0,0
2017,1.1210000000000000e+03,0,0,0,0,0
2017,1.1190000000000000e+03,0,0,0,0,0
2017,2.0700000000000000e+02,19212,798,179,0,20189
2017,4.3100000000000000e+02,0,0,0,0,0
2017,3.8700000000000000e+02,24829,3848,606,14,29297
2017,1.7900000000000000e+02,0,0,0,0,0
2017,6.0600000000000000e+02,22633,3922,443,15,27013
2017,9.2500000000000000e+02,114766,18576,320,56,133718
2017,5.4100000000000000e+02,13798,2185,535,24,16542
2017,7.9700000000000000e+02,16214,2944,313,30,19501
2017,6.2700000000000000e+02,32527,8652,279,37,41495
2017,1.7300000000000000e+02,0,0,0,0,0
2017,6.3600000000000000e+02,65375,11445,1032,121,77973
2017,2.0500000000000000e+02,7170,385,186,0,7741
2017,8.1400000000000000e+02,485,142,2,0,629
2017,8.8100000000000000e+02,11545,518,229,1,12293
2017,7.7100000000000000e+02,140477,11084,1995,110,153666
2017,5.3300000000000000e+02,11841,763,0,0,12604
2017,4.4700000000000000e+02,6992,1702,64,2,8760
2017,8.1500000000000000e+02,547,13,41,0,601
2017,8.0100000000000000e+02,114640,12196,1335,175,128346
2017,8.0000000000000000e+02,5137,381,61,1,5580
2017,3.8900000000000000e+02,63059,4885,452,1,68397
2017,6.9500000000000000e+02,77369,9767,664,75,87875
2017,8.1600000000000000e+02,44918,3444,341,57,48760
2017,8.3300000000000000e+02,71981,3806,989,27,76803
2017,8.7000000000000000e+02,35947,1649,46,0,37642
2017,9.2700000000000000e+02,54212,878,58,24,55172
2017,9.6100000000000000e+02,157446,11236,1156,126,169964
2017,9.6200000000000000e+02,11908,372,14,2,12296
2017,1.0790000000000000e+03,30378,0,0,0,30378
2017,1.1010000000000000e+03,60982,2442,0,0,63424
2017,6.6600000000000000e+02,89442,12839,1009,71,103361
2017,3.9200000000000000e+02,0,0,0,0,0
2017,7.9000000000000000e+02,14183,1891,143,6,16223
2017,6.5000000000000000e+02,35420,4419,551,29,40419
2017,8.7600000000000000e+02,51052,9913,795,55,61815
2017,9.4400000000000000e+02,0,59,0,0,59
2017,9.5200000000000000e+02,55720,2106,91,2,57919
2017,5.4000000000000000e+01,0,0,0,0,0
2017,3.6700000000000000e+02,21370,639,188,0,22197
2017,5.3800000000000000e+02,51198,8714,301,94,60307
2017,5.5700000000000000e+02,26676,2882,201,17,29776
2017,6.5300000000000000e+02,43235,4212,406,79,47932
2017,6.4700000000000000e+02,30488,3458,520,62,34528
2017,9.7800000000000000e+02,80921,14208,31,108,95268
2017,9.9600000000000000e+02,32220,2814,385,42,35461
2017,7.2900000000000000e+02,186341,21320,289,260,208210
2017,1.8200000000000000e+02,34814,1079,175,11,36079
2017,6.3300000000000000e+02,49131,808,77,0,50016
2017,6.8500000000000000e+02,57444,8187,561,63,66255
2017,6.8300000000000000e+02,28900,3535,354,36,32825
2017,9.4500000000000000e+02,47973,2451,843,54,51321
2017,9.5300000000000000e+02,11838,14,0,0,11852
2017,1.0220000000000000e+03,49407,372,1981,28,51788
2017,1.0490000000000000e+03,23760,287,1711,28,25786
2017,7.9400000000000000e+02,146751,26747,598,414,174510
2017,4.1500000000000000e+02,57,11,0,0,68
2017,5.9200000000000000e+02,43049,1672,95,3,44819
2017,4.9700000000000000e+02,10240,846,10,0,11096
2017,4.5800000000000000e+02,75959,3991,85,4,80039
2017,7.2600000000000000e+02,52875,10684,1140,151,64850
2017,2.7200000000000000e+02,17487,1265,278,0,19030
2017,8.0500000000000000e+02,132697,21802,58,206,154763
2017,2.3400000000000000e+02,27321,925,181,1,28428
2017,6.4000000000000000e+01,0,0,0,0,0
2017,8.4200000000000000e+02,23717,2805,1607,21,28150
2017,8.4300000000000000e+02,13583,1961,599,40,16183
2017,8.0300000000000000e+02,46702,9986,117,44,56849
2017,2.1100000000000000e+02,5726,518,95,0,6339
2017,7.7300000000000000e+02,59041,11690,2224,116,73071
2017,4.2400000000000000e+02,21977,423,49,0,22449
2017,2.9800000000000000e+02,23382,2305,78,2,25767
2017,5.9400000000000000e+02,5846,311,40,1,6198
2017,2.3700000000000000e+02,16297,33,198,1,16529
2017,1.6000000000000000e+01,0,0,0,0,0
2017,7.6800000000000000e+02,11102,1200,369,11,12682
2017,6.1700000000000000e+02,70500,6712,545,51,77808
2017,2.9700000000000000e+02,7387,2350,75,0,9812
2017,1.0500000000000000e+02,0,0,0,0,0
2017,5.4400000000000000e+02,34474,2211,314,8,37007
2017,8.0400000000000000e+02,58787,4917,966,52,64722
2017,1.0400000000000000e+02,0,0,0,0,0
2017,2.0000000000000000e+01,0,0,0,0,0
2017,5.5000000000000000e+02,33760,2092,981,36,36869
2017,1.1200000000000000e+02,0,0,0,0,0
2017,8.1800000000000000e+02,0,0,0,0,0
2017,8.8200000000000000e+02,0,0,0,0,0
2017,9.1400000000000000e+02,0,0,0,0,0
2017,9.2800000000000000e+02,0,0,0,0,0
2017,9.6400000000000000e+02,43546,7449,801,22,51818
2017,1.0260000000000000e+03,0,0,0,0,0
2017,1.0680000000000000e+03,0,0,0,0,0
2017,1.1080000000000000e+03,24875,1403,476,7,26761
2017,4.0400000000000000e+02,668,1,6,0,675
2017,2.7000000000000000e+02,63696,2371,147,13,66227
2017,6.7600000000000000e+02,29517,2858,399,55,32829
2017,7.0900000000000000e+02,80547,5094,837,71,86549
2017,7.5400000000000000e+02,364440,29887,3182,612,398121
2017,9.9700000000000000e+02,57219,2536,2562,9,62326
2017,1.0690000000000000e+03,34763,748,2685,8,38204
2017,1.1180000000000000e+03,50408,1445,36,0,51889
2017,7.3400000000000000e+02,83517,12874,82,72,96545
2017,2.9900000000000000e+02,17270,352,9,1,17632
2017,6.4500000000000000e+02,4964,65,20,20,5069
2017,1.7000000000000000e+01,0,0,0,0,0
2017,1.0460000000000000e+03,0,0,0,0,0
2017,4.2000000000000000e+02,2059,106,0,0,2165
2017,8.0200000000000000e+02,0,0,0,0,0
2017,2.6600000000000000e+02,27665,2503,0,0,30168
2017,1.3700000000000000e+02,6435,0,0,0,6435
2017,7.6900000000000000e+02,0,0,0,0,0
2017,7.7600000000000000e+02,38250,3012,437,14,41713
2017,6.4000000000000000e+02,37003,3082,774,10,40869
2017,3.1500000000000000e+02,0,0,0,0,0
2017,4.0000000000000000e+01,0,0,0,0,0
2017,5.0800000000000000e+02,14220,2493,368,5,17086
2017,4.6000000000000000e+01,0,0,0,0,0
2017,5.9000000000000000e+02,28408,4706,629,18,33761
2017,7.7700000000000000e+02,26946,3818,649,14,31427
2017,8.9700000000000000e+02,104367,28488,128,101,133084
2017,9.6500000000000000e+02,0,0,0,0,0
2017,4.6100000000000000e+02,1800,47,27,0,1874
2017,3.7600000000000000e+02,11090,397,51,2,11540
2017,6.2100000000000000e+02,23187,3125,356,36,26704
2017,7.9300000000000000e+02,145993,23391,795,199,170378
2017,1.1020000000000000e+03,86989,1887,88,1,88965
2017,,1420,29,17,0,1466
2017,7.1200000000000000e+02,27898,5937,834,28,34697
2017,3.2000000000000000e+01,0,0,0,0,0
2017,3.6100000000000000e+02,0,0,0,0,0
2017,2.4500000000000000e+02,28390,3883,145,1,32419
2017,6.0300000000000000e+02,137384,4732,606,6,142728
2017,4.2600000000000000e+02,0,0,0,0,0
2017,2.3200000000000000e+02,23564,2434,32,0,26030
2017,2.8800000000000000e+02,20733,715,279,0,21727
2017,2.4600000000000000e+02,11676,657,0,30,12363
2017,2.8400000000000000e+02,13072,1880,8,16,14976
2017,1.8000000000000000e+01,0,0,0,0,0
2017,3.5600000000000000e+02,1065,950,0,0,2015
2017,4.0100000000000000e+02,0,0,0,0,0
2017,7.3300000000000000e+02,137593,19041,364,99,157097
2017,2.4300000000000000e+02,16350,1963,134,4,18451
2017,3.8000000000000000e+02,0,0,0,0,0
2017,7.1600000000000000e+02,0,0,0,0,0
2017,5.3400000000000000e+02,87785,2242,39,0,90066
2017,1.8500000000000000e+02,3597,236,6,0,3839
2017,2.5800000000000000e+02,16313,2066,0,0,18379
2017,5.0500000000000000e+02,5446,52,0,0,5498
2017,2.6800000000000000e+02,44037,2434,0,0,46471
2017,6.0200000000000000e+02,0,0,0,0,0
2017,2.5400000000000000e+02,31951,2105,68,1,34125
2017,7.0500000000000000e+02,55203,3120,134,4,58461
2017,1.3300000000000000e+02,8850,2054,10,0,10914
2017,3.3000000000000000e+01,0,0,0,0,0
2017,1.4300000000000000e+02,2947,1123,8,0,4078
2017,3.6000000000000000e+01,0,0,0,0,0
2017,7.5600000000000000e+02,65518,6980,591,23,73112
2017,6.6200000000000000e+02,131760,11910,558,60,144288
2017,1.9200000000000000e+02,0,0,0,0,0
2017,3.8200000000000000e+02,0,0,0,0,0
2017,3.2200000000000000e+02,0,0,0,0,0
2017,4.7800000000000000e+02,9316,635,265,0,10216
2017,3.5200000000000000e+02,0,0,0,0,0
2017,6.2800000000000000e+02,98592,11588,591,61,110832
2017,2.9100000000000000e+02,0,0,0,0,0
2017,4.9500000000000000e+02,10199,1192,46,0,11437
2017,8.4500000000000000e+02,84692,8726,57,19,93494
2017,4.9800000000000000e+02,40059,2747,524,50,43380
2017,3.1400000000000000e+02,0,0,0,0,0
2017,7.2000000000000000e+02,30920,4108,11,2,35041
2017,7.2100000000000000e+02,102848,12576,653,31,116108
2017,4.8500000000000000e+02,0,0,0,0,0
2017,2.7300000000000000e+02,52999,5733,71,13,58816
2017,8.4600000000000000e+02,92604,10746,44,43,103437
2017,8.4700000000000000e+02,42926,644,62,0,43632
2017,8.4800000000000000e+02,57182,5263,104,0,62549
2017,9.1600000000000000e+02,1739,905,0,0,2644
2017,9.3000000000000000e+02,80608,3337,152,3,84100
2017,9.5400000000000000e+02,109961,11176,732,36,121905
2017,9.4300000000000000e+02,57703,3023,25,2,60753
2017,9.4900000000000000e+02,198388,29507,1274,181,229350
2017,9.8000000000000000e+02,121741,4133,451,3,126328
2017,9.8100000000000000e+02,12772,202,0,0,12974
2017,1.0240000000000000e+03,89335,5769,83,2,95189
2017,1.0170000000000000e+03,0,0,0,0,0
2017,1.0000000000000000e+03,85110,5714,448,6,91278
2017,1.0180000000000000e+03,102397,7345,345,50,110137
2017,1.0010000000000000e+03,40428,1781,86,3,42298
2017,1.0070000000000000e+03,110604,10122,315,101,121142
2017,1.0080000000000000e+03,74914,8378,247,31,83570
2017,1.0100000000000000e+03,84307,6148,92,28,90575
2017,1.0110000000000000e+03,55381,3373,112,24,58890
2017,1.0120000000000000e+03,95427,6773,33,47,102280
2017,1.0130000000000000e+03,145755,17916,860,89,164620
2017,1.0410000000000000e+03,0,0,0,0,0
2017,1.0730000000000000e+03,98190,6982,289,17,105478
2017,1.0870000000000000e+03,128331,14479,308,67,143185
2017,1.1090000000000000e+03,93550,6767,421,31,100769
2017,1.1100000000000000e+03,76425,5406,94,0,81925
2017,1.1120000000000000e+03,17756,326,177,0,18259
2017,1.1200000000000000e+03,0,0,0,0,0
2017,1.1260000000000000e+03,121582,10734,935,33,133284
2017,7.8900000000000000e+02,0,0,0,0,0
2017,3.2600000000000000e+02,0,0,0,0,0
2017,4.4200000000000000e+02,56811,3098,4,2,59915
2017,2.9400000000000000e+02,49564,2962,104,23,52653
2017,3.7800000000000000e+02,14104,762,25,0,14891
2017,4.0200000000000000e+02,10783,627,0,0,11410
2017,2.9000000000000000e+01,0,0,0,0,0
2017,4.5000000000000000e+02,758,3,0,0,761
2017,6.5600000000000000e+02,48319,3607,187,73,52186
2017,3.3300000000000000e+02,113865,3190,56,4,117115
2017,6.8400000000000000e+02,78463,4855,698,97,84113
2017,4.2200000000000000e+02,5479,111,0,0,5590
2017,7.6300000000000000e+02,322460,18821,1292,399,342972
2017,7.4100000000000000e+02,183518,13920,2646,276,200360
2017,5.5300000000000000e+02,105018,12796,609,215,118638
2017,3.5700000000000000e+02,95,0,0,0,95
2017,8.9900000000000000e+02,0,0,0,0,0
2017,9.0000000000000000e+02,0,0,0,0,0
2017,9.3200000000000000e+02,0,0,0,0,0
2017,9.5000000000000000e+02,0,0,0,0,0
2017,9.6600000000000000e+02,26185,1817,4,0,28006
2017,9.6700000000000000e+02,0,0,0,0,0
2017,9.8200000000000000e+02,68315,5034,94,2,73445
2017,1.0140000000000000e+03,57071,1,1620,3,58695
2017,1.0800000000000000e+03,110262,4696,9,2,114969
2017,1.0740000000000000e+03,13278,50,16,0,13344
2017,1.0840000000000000e+03,21311,15,17,0,21343
2017,1.1130000000000000e+03,199,48,0,0,247
2017,1.1370000000000000e+03,422,131,24,0,577
2017,1.1420000000000000e+03,39149,3687,316,55,43207
2017,7.2200000000000000e+02,178595,27245,1796,119,207755
2017,6.6000000000000000e+02,90789,8447,918,88,100242
2017,7.5000000000000000e+01,308,336,0,0,644
2017,2.4900000000000000e+02,36836,2233,0,0,39069
2017,2.2700000000000000e+02,46031,3572,29,0,49632
2017,1.5000000000000000e+02,2911,75,30,0,3016
2017,4.7000000000000000e+01,0,0,0,0,0
2017,1.7200000000000000e+02,4811,3,0,0,4814
2017,5.8100000000000000e+02,41425,3822,299,39,45585
2017,1.2000000000000000e+02,0,0,0,0,0
2017,4.4500000000000000e+02,0,0,0,0,0
2017,4.7100000000000000e+02,15080,1415,49,10,16554
2017,5.3000000000000000e+01,0,0,0,0,0
2017,1.9900000000000000e+02,6577,33,0,0,6610
2017,5.7500000000000000e+02,64477,6583,746,54,71860
2017,5.2800000000000000e+02,24469,3432,421,17,28339
2017,6.3100000000000000e+02,72105,9637,1020,67,82829
2017,6.9900000000000000e+02,74186,11327,1030,67,86610
2017,8.2300000000000000e+02,12094,107,15,0,12216
2017,8.4900000000000000e+02,37499,2094,269,17,39879
2017,8.6900000000000000e+02,60748,1337,316,5,62406
2017,9.5500000000000000e+02,0,3,0,0,3
2017,9.8300000000000000e+02,0,0,0,0,0
2017,1.0020000000000000e+03,0,0,0,0,0
2017,1.0150000000000000e+03,168150,19034,491,138,187813
2017,5.1000000000000000e+01,0,0,0,0,0
2017,4.4100000000000000e+02,0,0,0,0,0
2017,3.2700000000000000e+02,0,0,0,0,0
2017,6.9000000000000000e+02,14360,1630,17,1,16008
2017,2.6200000000000000e+02,15784,1239,46,3,17072
2017,4.0300000000000000e+02,0,0,0,0,0
2017,3.1200000000000000e+02,0,0,0,0,0
2017,5.8900000000000000e+02,22546,3126,421,22,26115
2017,6.6500000000000000e+02,45108,5504,523,41,51176
2017,3.3400000000000000e+02,0,0,0,0,0
2017,1.0750000000000000e+03,159128,26557,522,110,186317
2017,7.5100000000000000e+02,75558,22586,238,123,98505
2017,1.8600000000000000e+02,33465,639,95,0,34199
2017,6.4600000000000000e+02,9215,2759,478,18,12470
2017,5.3600000000000000e+02,10711,2099,538,24,13372
2017,2.4200000000000000e+02,6879,392,47,0,7318
2017,4.9000000000000000e+02,0,0,0,0,0
2017,5.0000000000000000e+02,24651,1540,223,4,26418
2017,2.0600000000000000e+02,17640,144,0,0,17784
2017,5.8000000000000000e+01,0,0,0,0,0
2017,5.7200000000000000e+02,57855,13261,1119,38,72273
2017,1.8000000000000000e+02,0,0,0,0,0
2017,5.4900000000000000e+02,11277,2185,255,9,13726
2017,5.8200000000000000e+02,17708,3264,380,22,21374
2017,7.4300000000000000e+02,85234,13187,1709,188,100318
2017,7.9500000000000000e+02,0,0,0,0,0
2017,2.6900000000000000e+02,5063,11,16,2,5092
2017,6.3400000000000000e+02,22195,5570,514,19,28298
2017,1.0000000000000000e+00,14423,446,132,0,15001
2017,7.1700000000000000e+02,28008,5452,494,46,34000
2017,3.7300000000000000e+02,967,0,0,0,967
2017,5.3500000000000000e+02,26064,4746,527,24,31361
2017,8.2400000000000000e+02,119728,22080,3313,112,145233
2017,8.8800000000000000e+02,17817,2345,515,14,20691
2017,9.0200000000000000e+02,0,0,0,0,0
2017,9.6800000000000000e+02,0,0,0,0,0
2017,1.1300000000000000e+03,0,0,0,0,0
2017,1.1410000000000000e+03,0,0,0,0,0
2017,1.1450000000000000e+03,0,0,0,0,0
2017,1.1220000000000000e+03,0,0,0,0,0
2017,1.1330000000000000e+03,0,0,0,0,0
2017,3.4600000000000000e+02,0,22,0,0,22
2017,2.7000000000000000e+01,0,0,0,0,0
2017,1.6500000000000000e+02,8728,285,62,0,9075
2017,9.5600000000000000e+02,35803,11362,333,71,47569
2017,4.1300000000000000e+02,0,0,0,0,0
2017,1.4900000000000000e+02,0,0,0,0,0
2017,6.1200000000000000e+02,46697,2883,454,2,50036
2017,5.5900000000000000e+02,1323,50,0,0,1373
2017,7.0000000000000000e+00,1045,5,0,0,1050
2017,2.8300000000000000e+02,48332,1654,191,2,50179
2017,3.7000000000000000e+01,0,0,0,0,0
2017,1.5300000000000000e+02,97754,795,216,0,98765
2017,5.4700000000000000e+02,57624,6760,151,33,64568
2017,3.9700000000000000e+02,0,0,0,0,0
2017,5.5600000000000000e+02,36579,4132,99,81,40891
2017,4.2000000000000000e+01,0,50,0,0,50
2017,3.1000000000000000e+01,0,0,0,0,0
2017,7.4000000000000000e+02,133087,17718,730,229,151764
2017,2.1700000000000000e+02,41479,3448,93,1,45021
2017,8.6300000000000000e+02,11248,1669,43,1,12961
2017,8.8900000000000000e+02,77883,10260,1010,392,89545
2017,9.8400000000000000e+02,38745,4712,835,16,44308
2017,1.1060000000000000e+03,12379,152,24,0,12555
2017,1.1460000000000000e+03,2334,1387,9,0,3730
2017,3.4000000000000000e+01,0,0,0,0,0
2017,7.9100000000000000e+02,21380,2143,73,0,23596
2017,1.8100000000000000e+02,0,0,0,0,0
2017,4.3000000000000000e+02,1402,29,45,0,1476
2017,7.1500000000000000e+02,85770,12732,336,28,98866
2017,5.2100000000000000e+02,5352,157,11,0,5520
2017,5.2400000000000000e+02,21053,1613,94,4,22764
2017,4.3200000000000000e+02,2741,362,16,0,3119
2017,1.9000000000000000e+01,19,0,0,0,19
2017,2.5000000000000000e+01,0,0,0,0,0
2017,2.6000000000000000e+01,0,0,0,0,0
2017,8.9000000000000000e+02,77922,15051,463,116,93552
2017,9.0400000000000000e+02,34548,3927,1138,36,39649
2017,9.5700000000000000e+02,152912,27447,302,162,180823
2017,9.3900000000000000e+02,135619,19535,20,114,155288
2017,2.3600000000000000e+02,30048,810,82,0,30940
2017,7.3500000000000000e+02,149959,18613,1244,292,170108
2017,1.4600000000000000e+02,0,0,0,0,0
2017,3.6300000000000000e+02,9102,422,29,1,9554
2017,1.8700000000000000e+02,9855,619,18,0,10492
2017,2.6500000000000000e+02,7243,185,0,0,7428
2017,2.9500000000000000e+02,28354,1081,10,1,29446
2017,4.9600000000000000e+02,44604,11843,4069,43,60559
2017,7.7000000000000000e+01,0,0,0,0,0
2017,3.9100000000000000e+02,4064,572,12,0,4648
2017,2.4000000000000000e+02,30126,2873,4317,30,37346
2017,4.4800000000000000e+02,8831,575,186,9,9601
2017,1.5100000000000000e+02,0,0,0,0,0
2017,4.2500000000000000e+02,5971,342,118,14,6445
2017,3.0000000000000000e+02,30157,2387,34,1,32579
2017,3.3900000000000000e+02,26751,1979,4,93,28827
2017,8.7400000000000000e+02,22720,4367,24,42,27153
2017,9.0500000000000000e+02,74492,13250,3749,438,91929
2017,1.1230000000000000e+03,0,0,0,0,0
2017,7.3600000000000000e+02,146915,21739,161,334,169149
2017,4.5900000000000000e+02,2968,15,0,0,2983
2017,3.2000000000000000e+02,0,0,0,0,0
2017,4.5000000000000000e+01,0,0,0,0,0
2017,6.1800000000000000e+02,37665,4192,663,54,42574
2017,4.6300000000000000e+02,97565,8080,1371,78,107094
2017,8.9100000000000000e+02,33533,2143,216,4,35896
2017,9.5800000000000000e+02,44625,7497,85,53,52260
2017,2.4400000000000000e+02,11914,229,78,0,12221
2017,2.8000000000000000e+01,0,0,0,0,0
2017,4.4400000000000000e+02,6516,331,46,0,6893
2017,4.7900000000000000e+02,0,0,0,0,0
2017,2.8500000000000000e+02,29324,1789,67,14,31194
2017,2.5300000000000000e+02,84309,4200,15,1,88525
2017,4.8100000000000000e+02,39066,1593,1,1,40661
2017,5.4000000000000000e+02,42873,5329,22,0,48224
2017,4.1000000000000000e+01,0,0,0,0,0
2017,5.1000000000000000e+02,45601,1104,72,1,46778
2017,3.0500000000000000e+02,40440,416,1493,8,42357
2017,7.0800000000000000e+02,63015,6136,451,137,69739
2017,7.5500000000000000e+02,265374,25038,4262,448,295122
2017,7.5000000000000000e+02,187077,22027,1521,237,210862
2017,6.9600000000000000e+02,111721,15742,863,174,128500
2017,4.2100000000000000e+02,19416,941,0,0,20357
2017,8.2700000000000000e+02,0,0,0,0,0
2017,9.3300000000000000e+02,92394,6335,1033,100,99862
2017,1.0300000000000000e+03,114742,4266,102,0,119110
2017,1.0030000000000000e+03,65952,88,2639,15,68694
2017,1.0500000000000000e+03,19127,124,702,6,19959
2017,1.0430000000000000e+03,64448,3584,34,0,68066
2017,1.1280000000000000e+03,54196,568,1731,13,56508
2017,1.1250000000000000e+03,,2,,0,2
2017,1.1350000000000000e+03,25960,5,1181,5,27151
2017,9.3400000000000000e+02,25638,5938,98,30,31704
2017,6.2900000000000000e+02,79674,9491,1586,108,90859
2017,2.1000000000000000e+01,0,0,0,0,0
2017,6.1500000000000000e+02,56214,4714,372,17,61317
2017,6.2600000000000000e+02,16924,424,7,0,17355
2017,4.1700000000000000e+02,6154,0,0,0,6154
2017,5.9700000000000000e+02,14626,2080,230,13,16949
2017,5.3900000000000000e+02,75219,10021,638,70,85948
2017,3.4300000000000000e+02,24158,399,131,3,24691
2017,1.3500000000000000e+02,0,0,0,0,0
2017,1.5800000000000000e+02,4015,875,0,0,4890
2017,7.7500000000000000e+02,37123,6806,518,50,44497
2017,1.7700000000000000e+02,0,0,0,0,0
2017,5.7800000000000000e+02,23589,427,276,0,24292
2017,4.1600000000000000e+02,27027,380,83,0,27490
2017,5.6100000000000000e+02,31639,3127,246,85,35097
2017,6.2000000000000000e+01,0,0,0,0,0
2017,8.2800000000000000e+02,0,0,0,0,0
2017,8.6000000000000000e+02,36756,1025,552,9,38342
2017,9.3500000000000000e+02,0,0,0,0,0
2017,9.3600000000000000e+02,0,0,0,0,0
2017,9.8600000000000000e+02,710,263,0,0,973
2017,9.8700000000000000e+02,68797,3726,1262,77,73862
2017,1.0210000000000000e+03,0,0,0,0,0
2017,1.0850000000000000e+03,0,0,0,0,0
2017,6.5800000000000000e+02,29550,5086,180,16,34832
2017,3.5300000000000000e+02,0,0,0,0,0
2017,3.2300000000000000e+02,0,0,0,0,0
2017,6.2000000000000000e+02,19762,3425,252,27,23466
2017,3.8400000000000000e+02,0,0,0,0,0
2017,5.5400000000000000e+02,62524,7772,251,144,70691
2017,2.0900000000000000e+02,13740,824,97,0,14661
2017,7.0700000000000000e+02,139152,24024,49,105,163330
2017,3.9500000000000000e+02,5748,42,0,0,5790
2017,9.6900000000000000e+02,43111,953,137,2,44203
2017,1.0520000000000000e+03,0,0,0,0,0
2017,7.3900000000000000e+02,223170,25995,6618,124,255907
2017,6.1300000000000000e+02,113056,15311,791,68,129226
2017,5.9300000000000000e+02,51210,9499,1106,66,61881
2017,7.0400000000000000e+02,145778,14710,989,107,161584
2017,4.9300000000000000e+02,0,0,0,0,0
2017,6.8600000000000000e+02,122710,14699,659,81,138149
2017,2.5700000000000000e+02,69187,4250,0,3,73440
2017,4.9400000000000000e+02,0,0,0,0,0
2017,6.8100000000000000e+02,5361,1898,6,2,7267
2017,2.8600000000000000e+02,12330,2233,25300,0,39863
2017,2.5500000000000000e+02,67526,1867,22,0,69415
2017,7.9000000000000000e+01,0,0,0,0,0
2017,8.1000000000000000e+01,0,0,0,0,0
2017,6.8800000000000000e+02,67692,11289,665,71,79717
2017,5.3100000000000000e+02,55561,7792,563,103,64019
2017,5.1400000000000000e+02,25400,2089,618,15,28122
2017,4.9900000000000000e+02,10119,2277,46,0,12442
2017,5.3200000000000000e+02,66197,6973,978,56,74204
2017,1.9000000000000000e+02,0,0,0,0,0
2017,5.9800000000000000e+02,22486,2407,543,48,25484
2017,2.6000000000000000e+02,103238,6782,225,6,110251
2017,8.3800000000000000e+02,1095,321,460,0,1876
2017,8.3900000000000000e+02,7847,52,29,0,7928
2017,8.5100000000000000e+02,0,0,0,0,0
2017,8.5200000000000000e+02,99640,15082,172,105,114999
2017,9.8800000000000000e+02,0,0,0,0,0
2017,1.0560000000000000e+03,96816,11495,194,87,108592
2017,1.0440000000000000e+03,0,0,0,0,0
2017,1.1140000000000000e+03,30711,3376,956,18,35061
2017,1.1290000000000000e+03,32037,1322,57,0,33416
2017,6.4400000000000000e+02,98431,16079,388,59,114957
2017,7.5200000000000000e+02,85509,12767,215,66,98557
2017,2.3800000000000000e+02,14860,1011,65,0,15936
2017,3.2500000000000000e+02,0,0,0,0,0
2017,6.2200000000000000e+02,25183,3033,443,24,28683
2017,8.7900000000000000e+02,9549,241,10,28,9828
2017,9.0600000000000000e+02,50758,1273,150,0,52181
2017,3.7000000000000000e+02,1362,4197,53,52,5664
2017,4.1800000000000000e+02,7037,661,31,0,7729
2017,5.7400000000000000e+02,9249,154,0,0,9403
2017,3.9900000000000000e+02,0,0,0,0,0
2017,1.9500000000000000e+02,2252,0,0,0,2252
2017,7.8300000000000000e+02,108225,21539,1383,233,131380
2017,2.6300000000000000e+02,13370,1510,60,0,14940
2017,1.9400000000000000e+02,3133,2,0,0,3135
2017,2.1400000000000000e+02,3792,56,0,0,3848
2017,7.8500000000000000e+02,168942,25514,2278,350,197084
2017,7.8000000000000000e+02,34925,3545,505,24,38999
2017,7.8200000000000000e+02,87548,12966,2775,151,103440
2017,3.6900000000000000e+02,0,0,0,0,0
2017,7.1300000000000000e+02,38924,158,2222,181,41485
2017,9.4100000000000000e+02,307,216,9,0,532
2017,1.0910000000000000e+03,0,0,0,0,0
2017,1.0450000000000000e+03,32196,1146,32,0,33374
2017,1.0860000000000000e+03,72768,4925,1178,18,78889
2017,9.3700000000000000e+02,58115,12268,447,67,70897
2017,1.0040000000000000e+03,7488,441,131,0,8060
2017,7.3700000000000000e+02,117968,16400,804,93,135265
2017,7.6500000000000000e+02,173615,28012,1918,217,203762
2017,3.2900000000000000e+02,70759,6825,1864,98,79546
2017,8.7000000000000000e+01,0,0,0,0,0
2017,5.2700000000000000e+02,21014,857,677,9,22557
2017,5.6200000000000000e+02,24648,1182,96,0,25926
2017,2.5100000000000000e+02,27990,1292,79,2,29363
2017,1.2900000000000000e+02,0,0,0,0,0
2017,1.5400000000000000e+02,0,0,0,0,0
2017,5.1600000000000000e+02,53970,5193,0,0,59163
2017,1.8400000000000000e+02,10493,113,33,0,10639
2017,6.5200000000000000e+02,10961,1762,97,0,12820
2017,6.3700000000000000e+02,21029,2934,347,18,24328
2017,8.8000000000000000e+01,0,0,0,0,0
2017,9.0700000000000000e+02,0,0,0,0,0
2017,9.7000000000000000e+02,0,0,0,0,0
2017,1.0190000000000000e+03,2462,500,421,4,3387
2017,1.0160000000000000e+03,45133,830,0,0,45963
2017,1.0470000000000000e+03,66462,4914,28,45,71449
2017,6.3500000000000000e+02,51952,7341,20,42,59355
