a√±o,NCODI,Urg_altas,Urg_ingresos,Urg_traslados,Urg_exitus,Urg_total
2016,1.1300000000000000e+02,0,0,0,0,0
2016,6.1900000000000000e+02,17378,1076,24,0,18478
2016,1.6300000000000000e+02,4226,97,8,0,4331
2016,1.3100000000000000e+02,0,0,0,0,0
2016,3.7500000000000000e+02,366,0,98,0,464
2016,1.0900000000000000e+03,145846,20921,1983,41,168791
2016,7.6400000000000000e+02,134451,17019,583,114,152167
2016,1.4000000000000000e+01,20023,574,491,2,21090
2016,6.5700000000000000e+02,32056,3376,369,0,35801
2016,3.6200000000000000e+02,20549,1233,210,1,21993
2016,9.8900000000000000e+02,23315,2463,463,23,26264
2016,9.9000000000000000e+02,30420,3580,607,23,34630
2016,6.8000000000000000e+02,126367,31634,1841,77,159919
2016,4.1100000000000000e+02,40595,2566,64,9,43234
2016,2.4100000000000000e+02,30026,2352,22,1,32401
2016,5.5800000000000000e+02,40108,7782,311,46,48247
2016,1.6700000000000000e+02,3355,58,103,0,3516
2016,2.4800000000000000e+02,10614,2816,176,1,13607
2016,2.2400000000000000e+02,22573,1023,42,2,23640
2016,5.9100000000000000e+02,71520,11860,595,77,84052
2016,5.8600000000000000e+02,76447,13636,1140,80,91303
2016,4.5300000000000000e+02,924,47,36,0,1007
2016,1.4500000000000000e+02,0,0,0,0,0
2016,5.1100000000000000e+02,68152,11868,678,73,80771
2016,5.3000000000000000e+02,61332,12001,415,50,73798
2016,6.0000000000000000e+00,25817,1125,20,0,26962
2016,1.6100000000000000e+02,0,0,0,0,0
2016,6.2300000000000000e+02,76313,12448,670,66,89497
2016,8.7500000000000000e+02,29240,3325,25,0,32590
2016,9.4600000000000000e+02,31968,5904,152,6,38030
2016,1.0230000000000000e+03,66977,12534,201,99,79811
2016,1.0540000000000000e+03,47808,8826,275,77,56986
2016,1.0570000000000000e+03,0,0,0,0,0
2016,1.0310000000000000e+03,0,0,0,0,0
2016,1.0320000000000000e+03,79218,9602,262,54,89136
2016,1.0640000000000000e+03,34040,2455,239,1,36735
2016,2.2600000000000000e+02,41783,2213,57,0,44053
2016,6.8700000000000000e+02,55378,5744,731,94,61947
2016,7.4500000000000000e+02,139347,16097,997,95,156536
2016,1.0900000000000000e+02,37305,3011,20,0,40336
2016,8.0800000000000000e+02,127638,10600,999,98,139335
2016,9.7100000000000000e+02,67930,495,2698,8,71131
2016,1.2800000000000000e+02,10407,530,0,0,10937
2016,9.1900000000000000e+02,32831,9820,300,47,42998
2016,7.2500000000000000e+02,129562,19658,0,61,149281
2016,3.0000000000000000e+00,0,0,0,0,0
2016,3.0600000000000000e+02,0,0,0,0,0
2016,1.5000000000000000e+01,7784,6,6,0,7796
2016,2.6400000000000000e+02,31455,2311,103,3,33872
2016,8.6700000000000000e+02,6703,0,0,0,6703
2016,9.1000000000000000e+02,34589,6441,630,57,41717
2016,1.0530000000000000e+03,54901,10321,993,86,66301
2016,1.0550000000000000e+03,63835,11485,1501,82,76903
2016,1.0810000000000000e+03,0,0,0,0,0
2016,1.0990000000000000e+03,2613,30,0,0,2643
2016,5.2900000000000000e+02,0,0,0,0,0
2016,3.4500000000000000e+02,0,0,0,0,0
2016,5.1500000000000000e+02,13643,581,0,0,14224
2016,1.7400000000000000e+02,0,0,0,0,0
2016,5.2300000000000000e+02,0,0,0,0,0
2016,6.9700000000000000e+02,82514,7596,366,5,90481
2016,2.3900000000000000e+02,37346,5079,230,2,42657
2016,2.8700000000000000e+02,58083,5585,91,178,63937
2016,3.7700000000000000e+02,0,0,0,0,0
2016,6.9200000000000000e+02,49096,6969,96,41,56202
2016,3.3500000000000000e+02,0,0,0,0,0
2016,4.3500000000000000e+02,23352,1540,71,3,24966
2016,4.2300000000000000e+02,9529,1588,0,0,11117
2016,3.5100000000000000e+02,17679,3331,207,11,21228
2016,8.1000000000000000e+02,8446,1162,0,0,9608
2016,8.3000000000000000e+02,61335,9319,529,25,71208
2016,8.9200000000000000e+02,92052,12548,572,98,105270
2016,9.2100000000000000e+02,89336,7233,141,6,96716
2016,9.9100000000000000e+02,17692,329,184,4,18209
2016,9.9200000000000000e+02,54870,5851,568,86,61375
2016,9.9300000000000000e+02,21134,3959,67,14,25174
2016,1.0700000000000000e+03,127615,17730,730,123,146198
2016,1.0950000000000000e+03,16726,1776,239,4,18745
2016,1.0940000000000000e+03,5572,839,30,0,6441
2016,4.7300000000000000e+02,29851,3843,41,0,33735
2016,6.6300000000000000e+02,107019,11528,4996,219,123762
2016,5.5200000000000000e+02,5258,18,275,0,5551
2016,7.7200000000000000e+02,81840,14618,4455,398,101311
2016,5.6800000000000000e+02,5853,309,0,0,6162
2016,3.9800000000000000e+02,7441,1122,9,0,8572
2016,3.9400000000000000e+02,6080,392,10,0,6482
2016,6.1400000000000000e+02,0,0,0,0,0
2016,2.3500000000000000e+02,2535,37,0,0,2572
2016,6.1600000000000000e+02,44882,1107,1866,7,47862
2016,2.6700000000000000e+02,18884,2676,849,2,22411
2016,5.6500000000000000e+02,0,0,0,0,0
2016,2.2000000000000000e+02,21150,1588,34,1,22773
2016,2.7800000000000000e+02,16578,2100,32,1,18711
2016,1.0700000000000000e+02,0,0,0,0,0
2016,7.1100000000000000e+02,121838,22159,7427,61,151485
2016,2.0400000000000000e+02,94,0,0,0,94
2016,5.7900000000000000e+02,94321,1040,27,1,95389
2016,3.4800000000000000e+02,0,0,0,0,0
2016,7.6600000000000000e+02,15138,1215,226,0,16579
2016,7.6100000000000000e+02,0,0,0,0,0
2016,7.2800000000000000e+02,37519,7177,269,16,44981
2016,2.8000000000000000e+02,43592,3515,147,2,47256
2016,2.2200000000000000e+02,1294,94,0,0,1388
2016,2.7600000000000000e+02,77541,3879,593,1,82014
2016,1.1000000000000000e+01,14019,3222,36,9,17286
2016,3.0200000000000000e+02,29660,343,74,2,30079
2016,6.8200000000000000e+02,16541,1689,192,12,18434
2016,2.7900000000000000e+02,85408,5308,387,2,91105
2016,2.8200000000000000e+02,84594,6408,73,0,91075
2016,2.8100000000000000e+02,44259,7021,88,46,51414
2016,1.8300000000000000e+02,1292,17,0,0,1309
2016,6.1000000000000000e+02,14289,43,0,0,14332
2016,1.1600000000000000e+02,0,0,0,0,0
2016,1.1500000000000000e+02,0,0,0,0,0
2016,1.1400000000000000e+02,0,0,0,0,0
2016,1.1900000000000000e+02,34,14,0,0,48
2016,7.7000000000000000e+02,101057,12873,1515,121,115566
2016,5.8300000000000000e+02,51993,2693,579,16,55281
2016,1.3600000000000000e+02,0,0,0,0,0
2016,4.6900000000000000e+02,27738,2354,161,8,30261
2016,6.4200000000000000e+02,44320,6932,920,103,52275
2016,6.7400000000000000e+02,133494,10242,129,1,143866
2016,1.9300000000000000e+02,0,0,0,0,0
2016,5.2600000000000000e+02,101887,10808,492,41,113228
2016,6.9800000000000000e+02,87200,13785,6813,260,108058
2016,6.3000000000000000e+02,53046,3890,780,19,57735
2016,1.2400000000000000e+02,0,0,0,0,0
2016,3.6400000000000000e+02,0,0,0,0,0
2016,4.3900000000000000e+02,33683,1438,350,0,35471
2016,5.7000000000000000e+02,95178,13014,2938,28,111158
2016,1.2300000000000000e+02,0,0,0,0,0
2016,3.1000000000000000e+02,1921,1115,0,0,3036
2016,5.7100000000000000e+02,49491,4752,1020,52,55315
2016,2.9600000000000000e+02,4727,0,0,0,4727
2016,5.6600000000000000e+02,74016,4794,464,72,79346
2016,7.8400000000000000e+02,121813,14140,3658,326,139937
2016,1.0200000000000000e+02,0,0,0,0,0
2016,3.7900000000000000e+02,0,0,0,0,0
2016,6.3900000000000000e+02,80311,7145,2378,20,89854
2016,4.5700000000000000e+02,26256,1513,280,13,28062
2016,6.0900000000000000e+02,115095,9392,146,4,124637
2016,1.0100000000000000e+02,0,0,0,0,0
2016,4.5400000000000000e+02,48988,6327,872,33,56220
2016,3.1800000000000000e+02,2836,1031,120,0,3987
2016,6.0000000000000000e+02,56310,6419,705,3,63437
2016,5.4500000000000000e+02,110225,7445,599,148,118417
2016,1.0000000000000000e+02,0,0,0,0,0
2016,7.0200000000000000e+02,111864,9196,1652,146,122858
2016,7.7800000000000000e+02,49901,9507,693,26,60127
2016,3.4100000000000000e+02,5870,213,10,0,6093
2016,9.9000000000000000e+01,0,0,0,0,0
2016,7.6700000000000000e+02,38744,5701,1292,39,45776
2016,3.5900000000000000e+02,43679,59,1305,2,45045
2016,9.8000000000000000e+01,0,0,0,0,0
2016,1.3200000000000000e+02,0,0,0,0,0
2016,9.7000000000000000e+01,0,0,0,0,0
2016,1.0300000000000000e+02,0,0,0,0,0
2016,1.1000000000000000e+02,0,0,0,0,0
2016,9.4000000000000000e+01,0,0,0,0,0
2016,9.1000000000000000e+01,0,0,0,0,0
2016,6.6400000000000000e+02,100042,11239,1000,102,112383
2016,9.1800000000000000e+02,175318,30359,3625,280,209582
2016,9.2000000000000000e+01,0,0,0,0,0
2016,9.5000000000000000e+01,0,0,0,0,0
2016,3.0100000000000000e+02,17485,0,42,0,17527
2016,4.9200000000000000e+02,46586,3760,981,22,51349
2016,8.1100000000000000e+02,10724,1249,12,5,11990
2016,8.1200000000000000e+02,0,0,0,0,0
2016,8.3200000000000000e+02,0,0,0,0,0
2016,8.4100000000000000e+02,0,0,0,0,0
2016,8.5600000000000000e+02,0,0,0,0,0
2016,8.5900000000000000e+02,0,0,0,0,0
2016,8.6100000000000000e+02,0,0,0,0,0
2016,8.8000000000000000e+02,0,0,0,0,0
2016,8.8300000000000000e+02,0,0,0,0,0
2016,8.8400000000000000e+02,0,0,0,0,0
2016,8.7700000000000000e+02,0,0,0,0,0
2016,9.1100000000000000e+02,0,0,0,0,0
2016,9.1300000000000000e+02,1873,319,95,0,2287
2016,9.2200000000000000e+02,39980,2387,0,3,42370
2016,9.2300000000000000e+02,0,0,0,0,0
2016,9.2400000000000000e+02,0,0,0,0,0
2016,9.4700000000000000e+02,0,0,0,0,0
2016,9.5100000000000000e+02,0,0,0,0,0
2016,1.1030000000000000e+03,0,0,0,0,0
2016,9.7200000000000000e+02,0,0,0,0,0
2016,9.7300000000000000e+02,11253,62,4,0,11319
2016,9.7400000000000000e+02,0,0,0,0,0
2016,9.7500000000000000e+02,0,0,0,0,0
2016,9.6000000000000000e+02,0,0,0,0,0
2016,1.0280000000000000e+03,0,0,0,0,0
2016,9.7600000000000000e+02,0,0,0,0,0
2016,9.7700000000000000e+02,0,0,0,0,0
2016,1.0200000000000000e+03,0,0,0,0,0
2016,9.9400000000000000e+02,55596,6669,737,15,63017
2016,9.9500000000000000e+02,0,0,0,0,0
2016,1.0600000000000000e+03,335,255,58,0,648
2016,1.0050000000000000e+03,0,0,0,0,0
2016,1.0610000000000000e+03,0,0,0,0,0
2016,1.0060000000000000e+03,0,0,0,0,0
2016,1.0880000000000000e+03,0,0,0,0,0
2016,1.0890000000000000e+03,39479,1197,129,0,40805
2016,1.0760000000000000e+03,0,0,0,0,0
2016,1.0780000000000000e+03,0,0,0,0,0
2016,1.0330000000000000e+03,56460,8450,2019,114,67043
2016,1.0370000000000000e+03,0,0,0,0,0
2016,1.0390000000000000e+03,0,0,0,0,0
2016,1.0670000000000000e+03,0,0,0,0,0
2016,1.0650000000000000e+03,0,0,0,0,0
2016,1.0660000000000000e+03,33157,1721,58,0,34936
2016,1.1000000000000000e+03,0,0,0,0,0
2016,1.1050000000000000e+03,0,0,0,0,0
2016,1.1070000000000000e+03,0,0,0,0,0
2016,1.1110000000000000e+03,0,0,0,0,0
2016,1.1210000000000000e+03,0,0,0,0,0
2016,2.0700000000000000e+02,17598,454,84,0,18136
2016,4.3100000000000000e+02,0,0,0,0,0
2016,3.8700000000000000e+02,24943,3974,651,19,29587
2016,1.7900000000000000e+02,0,0,0,0,0
2016,6.0600000000000000e+02,22809,4131,473,19,27432
2016,9.2500000000000000e+02,114152,19116,222,70,133560
2016,5.4100000000000000e+02,15724,2377,513,18,18632
2016,7.9700000000000000e+02,15817,2616,293,22,18748
2016,6.2700000000000000e+02,34540,8495,305,89,43429
2016,1.7300000000000000e+02,0,0,0,0,0
2016,6.3600000000000000e+02,66705,11757,1012,118,79592
2016,2.0500000000000000e+02,7170,385,186,0,7741
2016,8.1400000000000000e+02,467,89,3,0,559
2016,8.8100000000000000e+02,12043,489,244,0,12776
2016,7.7100000000000000e+02,117000,10501,821,88,128410
2016,5.3300000000000000e+02,11098,791,0,0,11889
2016,4.4700000000000000e+02,6515,1879,78,1,8473
2016,8.1500000000000000e+02,510,9,38,0,557
2016,8.0100000000000000e+02,119629,12713,1201,191,133734
2016,8.0000000000000000e+02,5477,387,54,0,5918
2016,3.8900000000000000e+02,63015,4831,655,6,68507
2016,6.9500000000000000e+02,80147,10384,530,90,91151
2016,8.1600000000000000e+02,44931,3829,395,29,49184
2016,8.3300000000000000e+02,72160,3790,991,17,76958
2016,8.7000000000000000e+02,32449,1539,66,2,34056
2016,9.2700000000000000e+02,60310,835,46,19,61210
2016,9.6100000000000000e+02,162211,11821,1158,135,175325
2016,9.6200000000000000e+02,12449,558,7,2,13016
2016,1.0790000000000000e+03,25904,0,0,0,25904
2016,1.1010000000000000e+03,50387,2582,58,1,53028
2016,6.6600000000000000e+02,89195,13320,930,71,103516
2016,3.9200000000000000e+02,0,0,0,0,0
2016,7.9000000000000000e+02,13447,1895,172,2,15516
2016,6.5000000000000000e+02,34281,4540,488,29,39338
2016,8.7600000000000000e+02,48725,9763,819,58,59365
2016,9.4400000000000000e+02,0,60,0,0,60
2016,9.5200000000000000e+02,52109,2109,51,2,54271
2016,5.4000000000000000e+01,0,0,0,0,0
2016,3.6700000000000000e+02,20481,603,195,3,21282
2016,5.3800000000000000e+02,50783,8438,307,84,59612
2016,5.5700000000000000e+02,25909,2993,185,9,29096
2016,6.5300000000000000e+02,40454,5023,735,55,46267
2016,6.4700000000000000e+02,29813,3469,463,56,33801
2016,9.7800000000000000e+02,80861,14085,29,77,95052
2016,9.9600000000000000e+02,32432,2844,355,37,35668
2016,7.2900000000000000e+02,188828,19033,3237,267,211365
2016,1.8200000000000000e+02,36188,1215,181,4,37588
2016,6.3300000000000000e+02,32575,132,60,0,32767
2016,6.8500000000000000e+02,56347,8344,541,48,65280
2016,6.8300000000000000e+02,28050,3719,379,41,32189
2016,9.4500000000000000e+02,44329,2416,792,39,47576
2016,9.5300000000000000e+02,13917,15,0,0,13932
2016,1.0220000000000000e+03,45957,448,2136,20,48561
2016,1.0490000000000000e+03,22187,306,1676,18,24187
2016,7.9400000000000000e+02,142780,25834,1184,440,170238
2016,4.1500000000000000e+02,73,16,0,0,89
2016,5.9200000000000000e+02,39686,1882,59,0,41627
2016,4.9700000000000000e+02,11058,914,12,0,11984
2016,4.5800000000000000e+02,76495,4287,88,8,80878
2016,7.2600000000000000e+02,52977,10235,1349,125,64686
2016,2.7200000000000000e+02,16763,1134,280,0,18177
2016,8.0500000000000000e+02,133974,21219,34,217,155444
2016,5.0000000000000000e+00,0,0,0,0,0
2016,2.3400000000000000e+02,27725,721,208,3,28657
2016,6.4000000000000000e+01,0,0,0,0,0
2016,8.4200000000000000e+02,23813,2937,1504,24,28278
2016,8.4300000000000000e+02,14250,2022,617,32,16921
2016,8.0300000000000000e+02,46376,10274,112,42,56804
2016,2.1100000000000000e+02,5765,108,24,0,5897
2016,7.7300000000000000e+02,58741,10695,2035,104,71575
2016,4.2400000000000000e+02,18952,401,56,0,19409
2016,2.9800000000000000e+02,22739,2400,107,1,25247
2016,5.9400000000000000e+02,6112,245,15,0,6372
2016,2.3700000000000000e+02,15974,36,221,0,16231
2016,1.6000000000000000e+01,0,0,0,0,0
2016,7.6800000000000000e+02,10906,1195,374,8,12483
2016,6.1700000000000000e+02,68714,6845,595,74,76228
2016,2.9700000000000000e+02,9120,2415,147,0,11682
2016,1.0500000000000000e+02,0,0,0,0,0
2016,5.4400000000000000e+02,33355,1834,273,14,35476
2016,8.0400000000000000e+02,59077,4954,789,52,64872
2016,1.0400000000000000e+02,0,0,0,0,0
2016,2.0000000000000000e+01,0,0,0,0,0
2016,5.5000000000000000e+02,35862,2651,1016,34,39563
2016,1.1200000000000000e+02,0,0,0,0,0
2016,8.1800000000000000e+02,0,0,0,0,0
2016,8.8200000000000000e+02,0,0,0,0,0
2016,9.1400000000000000e+02,0,0,0,0,0
2016,9.2800000000000000e+02,0,0,0,0,0
2016,9.6400000000000000e+02,42770,7069,750,22,50611
2016,1.0260000000000000e+03,0,0,0,0,0
2016,1.0680000000000000e+03,0,0,0,0,0
2016,1.1080000000000000e+03,24999,1390,433,7,26829
2016,4.0400000000000000e+02,1179,5,7,0,1191
2016,2.7000000000000000e+02,58870,2457,284,4,61615
2016,6.7600000000000000e+02,28694,2997,323,60,32074
2016,7.0900000000000000e+02,72863,5437,788,73,79161
2016,7.5400000000000000e+02,353753,30088,4080,523,388444
2016,9.9700000000000000e+02,56139,2472,2370,12,60993
2016,1.0690000000000000e+03,25344,575,1862,1,27782
2016,1.1180000000000000e+03,46070,1321,32,0,47423
2016,7.3400000000000000e+02,81748,12977,59,73,94857
2016,2.9900000000000000e+02,16453,369,17,1,16840
2016,6.4500000000000000e+02,14225,35,0,0,14260
2016,1.7000000000000000e+01,0,0,0,0,0
2016,1.0460000000000000e+03,0,0,0,0,0
2016,4.2000000000000000e+02,2506,105,0,0,2611
2016,8.0200000000000000e+02,0,0,0,0,0
2016,2.6600000000000000e+02,25769,2719,0,1,28489
2016,1.3700000000000000e+02,6744,7,26,0,6777
2016,7.6900000000000000e+02,0,0,0,0,0
2016,7.7600000000000000e+02,39517,3219,524,17,43277
2016,6.4000000000000000e+02,37986,3095,729,9,41819
2016,3.1500000000000000e+02,0,0,0,0,0
2016,4.0000000000000000e+01,0,0,0,0,0
2016,5.0800000000000000e+02,13639,2465,365,7,16476
2016,4.6000000000000000e+01,0,0,0,0,0
2016,5.9000000000000000e+02,29290,4797,620,25,34732
2016,7.7700000000000000e+02,28288,3626,690,8,32612
2016,8.9700000000000000e+02,106763,28802,109,97,135771
2016,9.6500000000000000e+02,0,0,0,0,0
2016,4.6100000000000000e+02,2183,107,34,0,2324
2016,3.7600000000000000e+02,12567,476,71,3,13117
2016,6.2100000000000000e+02,23378,3090,427,54,26949
2016,7.9300000000000000e+02,147327,23599,714,210,171850
2016,1.1020000000000000e+03,77262,1694,60,0,79016
2016,7.1200000000000000e+02,27454,6525,294,22,34295
2016,3.2000000000000000e+01,0,0,0,0,0
2016,3.6100000000000000e+02,0,0,0,0,0
2016,4.8600000000000000e+02,9511,695,32,0,10238
2016,5.9500000000000000e+02,27262,4944,331,54,32591
2016,4.3300000000000000e+02,10596,960,546,4,12106
2016,1.0580000000000000e+03,791,388,209,1,1389
2016,2.6100000000000000e+02,18518,1142,267,6,19933
2016,7.3000000000000000e+02,63790,5361,1077,59,70287
2016,5.7700000000000000e+02,36096,7125,714,47,43982
2016,7.8800000000000000e+02,128762,17139,2375,68,148344
2016,8.6500000000000000e+02,54619,2956,723,75,58373
2016,9.7900000000000000e+02,15606,559,1250,3,17418
2016,9.9800000000000000e+02,18828,146,985,2,19961
2016,1.0720000000000000e+03,23508,242,1548,11,25309
2016,2.2100000000000000e+02,3560,1237,42,1,4840
2016,5.0600000000000000e+02,23501,652,307,2,24462
2016,7.2700000000000000e+02,47219,9581,514,66,57380
2016,3.5500000000000000e+02,17,17,6514,0,6548
2016,4.8700000000000000e+02,2017,273,59,1,2350
2016,9.3800000000000000e+02,105105,20928,4972,198,131203
2016,8.8600000000000000e+02,2102,2351,8,0,4461
2016,8.3500000000000000e+02,4248,110,0,0,4358
2016,9.9900000000000000e+02,0,0,0,0,0
2016,7.9800000000000000e+02,76653,14472,2778,196,94099
2016,5.0400000000000000e+02,3435,1246,89,0,4770
2016,2.4700000000000000e+02,23310,1347,65,0,24722
2016,2.1600000000000000e+02,18527,1353,40,2,19922
2016,6.5400000000000000e+02,10635,1071,28,0,11734
2016,6.5000000000000000e+01,0,0,0,0,0
2016,4.7200000000000000e+02,14220,1150,338,6,15714
2016,4.2700000000000000e+02,0,0,0,0,0
2016,4.9100000000000000e+02,7973,1062,252,5,9292
2016,5.5100000000000000e+02,13901,572,141,5,14619
2016,1.0600000000000000e+02,0,0,0,0,0
2016,8.1900000000000000e+02,0,0,0,0,0
2016,8.3600000000000000e+02,0,0,0,0,0
2016,9.1500000000000000e+02,0,0,0,0,0
2016,9.4200000000000000e+02,0,0,0,0,0
2016,7.4800000000000000e+02,88499,17109,85,59,105752
2016,1.9800000000000000e+02,0,0,0,0,0
2016,8.7100000000000000e+02,17475,2846,648,15,20984
2016,9.4800000000000000e+02,28635,1049,59,0,29743
2016,1.0510000000000000e+03,0,0,0,0,0
2016,1.0830000000000000e+03,0,0,0,0,0
2016,1.0960000000000000e+03,0,0,0,0,0
2016,6.7900000000000000e+02,80941,15469,190,119,96719
2016,1.7600000000000000e+02,9332,506,62,0,9900
2016,5.3700000000000000e+02,16330,925,369,3,17627
2016,6.0800000000000000e+02,20344,3618,298,84,24344
2016,5.9600000000000000e+02,11722,3080,394,67,15263
2016,7.4900000000000000e+02,128803,17467,789,175,147234
2016,7.5800000000000000e+02,217418,27607,1144,232,246401
2016,1.1040000000000000e+03,107449,22476,894,120,130939
2016,4.3600000000000000e+02,0,0,0,0,0
2016,5.6700000000000000e+02,35,10,3,0,48
2016,6.7700000000000000e+02,85675,9950,756,77,96458
2016,6.7000000000000000e+02,66459,3345,85,1,69890
2016,5.8800000000000000e+02,0,0,0,0,0
2016,7.5300000000000000e+02,219273,30365,449,162,250249
2016,8.8700000000000000e+02,148,813,35,0,996
2016,2.4500000000000000e+02,24951,3853,232,14,29050
2016,6.0300000000000000e+02,139639,4907,536,4,145086
2016,4.2600000000000000e+02,0,0,0,0,0
2016,2.3200000000000000e+02,21354,2243,16,0,23613
2016,2.8800000000000000e+02,19976,570,253,6,20805
2016,2.4600000000000000e+02,9001,645,36,0,9682
2016,2.8400000000000000e+02,12137,1810,18,8,13973
2016,1.8000000000000000e+01,0,0,0,0,0
2016,3.5600000000000000e+02,919,977,0,0,1896
2016,4.0100000000000000e+02,0,0,0,0,0
2016,7.3300000000000000e+02,130591,18136,325,87,149139
2016,2.4300000000000000e+02,16102,2005,11,2,18120
2016,3.8000000000000000e+02,0,0,0,0,0
2016,7.1600000000000000e+02,10304,650,9,0,10963
2016,5.3400000000000000e+02,80648,2711,43,0,83402
2016,1.8500000000000000e+02,3573,318,7,0,3898
2016,2.5800000000000000e+02,13592,2040,0,1,15633
2016,5.0500000000000000e+02,5152,26,30,0,5208
2016,2.6800000000000000e+02,28603,1259,0,0,29862
2016,6.0200000000000000e+02,0,0,0,0,0
2016,2.5400000000000000e+02,30302,1839,61,2,32204
2016,7.0500000000000000e+02,54711,3084,123,3,57921
2016,1.3300000000000000e+02,8953,2259,11,0,11223
2016,3.3000000000000000e+01,0,0,0,0,0
2016,1.4300000000000000e+02,2428,624,9,0,3061
2016,3.6000000000000000e+01,0,0,0,0,0
2016,7.5600000000000000e+02,61868,6656,567,27,69118
2016,6.6200000000000000e+02,129063,12112,647,66,141888
2016,1.9200000000000000e+02,0,0,0,0,0
2016,3.8200000000000000e+02,0,0,0,0,0
2016,3.2200000000000000e+02,0,0,0,0,0
2016,4.7800000000000000e+02,9907,569,373,0,10849
2016,3.5200000000000000e+02,0,0,0,0,0
2016,6.2800000000000000e+02,99643,11382,550,62,111637
2016,2.9100000000000000e+02,0,0,0,0,0
2016,4.9500000000000000e+02,10259,976,62,0,11297
2016,8.4500000000000000e+02,83612,8582,84,11,92289
2016,4.9800000000000000e+02,38235,2790,814,50,41889
2016,3.1400000000000000e+02,0,0,0,0,0
2016,7.2000000000000000e+02,28782,3975,4,3,32764
2016,7.2100000000000000e+02,101359,12607,534,39,114539
2016,4.8500000000000000e+02,0,0,0,0,0
2016,2.7300000000000000e+02,55599,5967,136,19,61721
2016,8.4600000000000000e+02,93542,10581,48,57,104228
2016,8.4700000000000000e+02,40976,702,76,0,41754
2016,8.4800000000000000e+02,57654,5314,105,0,63073
2016,9.1600000000000000e+02,1167,1122,1,0,2290
2016,9.3000000000000000e+02,79857,3301,117,5,83280
2016,9.5400000000000000e+02,107376,11279,644,27,119326
2016,9.4300000000000000e+02,58656,2918,73,1,61648
2016,9.4900000000000000e+02,199779,28321,1606,224,229930
2016,9.8000000000000000e+02,123866,4151,652,4,128673
2016,9.8100000000000000e+02,11155,212,0,0,11367
2016,1.0240000000000000e+03,89117,5752,80,1,94950
2016,1.0170000000000000e+03,0,0,0,0,0
2016,1.0000000000000000e+03,82876,5911,526,4,89317
2016,1.0180000000000000e+03,99565,7066,394,34,107059
2016,1.0010000000000000e+03,41351,2176,64,1,43592
2016,1.0070000000000000e+03,109286,10099,316,106,119807
2016,1.0080000000000000e+03,76048,8108,244,25,84425
2016,1.0090000000000000e+03,116284,9619,1918,30,127851
2016,1.0100000000000000e+03,81605,6050,121,21,87797
2016,1.0110000000000000e+03,55113,3354,155,30,58652
2016,1.0120000000000000e+03,93172,6582,43,47,99844
2016,1.0130000000000000e+03,141576,17846,668,96,160186
2016,1.0410000000000000e+03,0,0,0,0,0
2016,1.0730000000000000e+03,76146,26480,0,24,102650
2016,1.0870000000000000e+03,121277,14367,319,52,136015
2016,1.1090000000000000e+03,85271,6727,401,25,92424
2016,1.1100000000000000e+03,67451,5245,5,0,72701
2016,1.1120000000000000e+03,15394,229,92,0,15715
2016,7.8900000000000000e+02,0,0,0,0,0
2016,3.2600000000000000e+02,0,0,0,0,0
2016,4.4200000000000000e+02,50977,3386,2694,2,57059
2016,2.9400000000000000e+02,47081,2987,99,10,50177
2016,3.7800000000000000e+02,14106,755,30,0,14891
2016,4.0200000000000000e+02,11566,724,0,0,12290
2016,2.9000000000000000e+01,0,0,0,0,0
2016,4.5000000000000000e+02,953,5,0,0,958
2016,6.5600000000000000e+02,60876,4524,386,71,65857
2016,3.3300000000000000e+02,106478,2676,87,0,109241
2016,6.6800000000000000e+02,38527,3405,324,56,42312
2016,6.8400000000000000e+02,75569,5212,603,122,81506
2016,4.2200000000000000e+02,0,65,0,0,65
2016,7.6300000000000000e+02,317112,20928,1410,205,339655
2016,7.4100000000000000e+02,151151,13426,1388,281,166246
2016,5.5300000000000000e+02,100628,12941,592,204,114365
2016,3.5700000000000000e+02,263,23,0,0,286
2016,8.9900000000000000e+02,0,0,0,0,0
2016,9.0000000000000000e+02,0,0,0,0,0
2016,9.3200000000000000e+02,0,0,0,0,0
2016,9.5000000000000000e+02,0,0,0,0,0
2016,9.6600000000000000e+02,22390,2140,14,0,24544
2016,9.6700000000000000e+02,0,0,0,0,0
2016,9.8200000000000000e+02,65982,4858,102,2,70944
2016,1.0140000000000000e+03,58307,2,1644,1,59954
2016,1.0800000000000000e+03,108096,4814,8,0,112918
2016,1.0740000000000000e+03,12609,10,6,0,12625
2016,1.0840000000000000e+03,19388,23,32,0,19443
2016,1.1130000000000000e+03,171,7,0,0,178
2016,7.2200000000000000e+02,178226,27044,1722,95,207087
2016,6.6000000000000000e+02,89255,8613,830,63,98761
2016,7.5000000000000000e+01,266,326,0,0,592
2016,2.4900000000000000e+02,34704,2059,0,0,36763
2016,2.7500000000000000e+02,0,0,0,0,0
2016,2.2700000000000000e+02,45404,3636,64,5,49109
2016,1.5000000000000000e+02,3016,75,0,0,3091
2016,4.7000000000000000e+01,0,0,0,0,0
2016,1.7200000000000000e+02,4338,0,0,0,4338
2016,5.8100000000000000e+02,42572,3815,397,43,46827
2016,1.2000000000000000e+02,0,0,0,0,0
2016,4.4500000000000000e+02,0,0,0,0,0
2016,4.7100000000000000e+02,14130,1448,25,17,15620
2016,5.3000000000000000e+01,0,0,0,0,0
2016,1.9900000000000000e+02,6270,43,0,0,6313
2016,5.7500000000000000e+02,61335,6995,709,36,69075
2016,5.2800000000000000e+02,23981,3396,302,15,27694
2016,6.3100000000000000e+02,70926,9497,1118,68,81609
2016,6.9900000000000000e+02,74032,10711,885,64,85692
2016,8.2300000000000000e+02,11795,116,17,0,11928
2016,8.4900000000000000e+02,35415,2034,269,14,37732
2016,8.6900000000000000e+02,59562,1535,277,1,61375
2016,9.5500000000000000e+02,0,0,0,0,0
2016,9.8300000000000000e+02,0,0,0,0,0
2016,1.0020000000000000e+03,0,0,0,0,0
2016,1.0150000000000000e+03,160210,18480,459,101,179250
2016,5.1000000000000000e+01,0,0,0,0,0
2016,4.4100000000000000e+02,0,0,0,0,0
2016,3.2700000000000000e+02,0,0,0,0,0
2016,6.9000000000000000e+02,13884,1720,5,0,15609
2016,2.6200000000000000e+02,15398,1223,40,4,16665
2016,4.0300000000000000e+02,0,0,0,0,0
2016,3.1200000000000000e+02,0,0,0,0,0
2016,5.8900000000000000e+02,22533,3330,411,17,26291
2016,6.6500000000000000e+02,44947,5344,502,28,50821
2016,3.3400000000000000e+02,0,0,0,0,0
2016,1.0750000000000000e+03,156836,25965,704,98,183603
2016,7.5100000000000000e+02,77056,21426,151,144,98777
2016,1.8600000000000000e+02,33167,582,70,0,33819
2016,6.4600000000000000e+02,8404,2633,451,21,11509
2016,5.3600000000000000e+02,10878,2002,561,29,13470
2016,2.4200000000000000e+02,6175,452,51,2,6680
2016,4.9000000000000000e+02,0,0,0,0,0
2016,5.0000000000000000e+02,17681,1546,263,3,19493
2016,2.0600000000000000e+02,22765,176,0,0,22941
2016,5.8000000000000000e+01,5,41,0,0,46
2016,5.7200000000000000e+02,57037,13649,1089,63,71838
2016,1.8000000000000000e+02,0,0,0,0,0
2016,5.4900000000000000e+02,11467,1876,227,7,13577
2016,5.8200000000000000e+02,17835,3252,352,22,21461
2016,7.4300000000000000e+02,84840,13487,1743,194,100264
2016,7.9500000000000000e+02,0,0,0,0,0
2016,2.6900000000000000e+02,4896,35,10,3,4944
2016,6.3400000000000000e+02,22295,5795,451,18,28559
2016,1.0000000000000000e+00,13627,601,120,0,14348
2016,7.1700000000000000e+02,28914,5562,476,38,34990
2016,3.7300000000000000e+02,918,0,0,0,918
2016,5.3500000000000000e+02,26452,4859,503,30,31844
2016,8.2400000000000000e+02,119474,21599,3315,160,144548
2016,8.8800000000000000e+02,17488,2310,458,16,20272
2016,9.0200000000000000e+02,0,0,0,0,0
2016,9.6800000000000000e+02,0,0,0,0,0
2016,3.4600000000000000e+02,0,10,0,0,10
2016,2.7000000000000000e+01,0,0,0,0,0
2016,1.6500000000000000e+02,8759,209,82,2,9052
2016,9.5600000000000000e+02,36992,11128,329,57,48506
2016,4.1300000000000000e+02,0,0,0,0,0
2016,1.4900000000000000e+02,0,0,0,0,0
2016,6.1200000000000000e+02,46524,2770,469,2,49765
2016,5.5900000000000000e+02,1318,56,0,0,1374
2016,7.0000000000000000e+00,911,3,78,0,992
2016,2.8300000000000000e+02,46184,1562,187,5,47938
2016,3.7000000000000000e+01,0,0,0,0,0
2016,1.5300000000000000e+02,92034,952,223,0,93209
2016,5.4700000000000000e+02,56073,6191,185,30,62479
2016,3.9700000000000000e+02,0,0,0,0,0
2016,5.5600000000000000e+02,35198,4128,56,37,39419
2016,4.2000000000000000e+01,0,41,0,0,41
2016,3.1000000000000000e+01,0,0,0,0,0
2016,7.4000000000000000e+02,129241,17172,780,218,147411
2016,2.1700000000000000e+02,35107,3241,156,0,38504
2016,8.6300000000000000e+02,10709,1767,101,1,12578
2016,8.8900000000000000e+02,76506,10031,1024,431,87992
2016,9.8400000000000000e+02,36653,4232,1016,12,41913
2016,1.1060000000000000e+03,9430,262,43,0,9735
2016,3.4000000000000000e+01,0,0,0,0,0
2016,7.9100000000000000e+02,20271,2300,61,0,22632
2016,1.8100000000000000e+02,0,0,0,0,0
2016,4.3000000000000000e+02,1901,59,45,0,2005
2016,7.1500000000000000e+02,82584,11642,298,27,94551
2016,5.2100000000000000e+02,5342,1263,33,0,6638
2016,5.2400000000000000e+02,21247,1778,75,7,23107
2016,4.3200000000000000e+02,2670,388,14,0,3072
2016,1.9000000000000000e+01,25,0,0,0,25
2016,2.5000000000000000e+01,0,0,0,0,0
2016,2.6000000000000000e+01,0,0,0,0,0
2016,8.9000000000000000e+02,76523,14599,441,127,91690
2016,9.0400000000000000e+02,32896,3545,966,40,37447
2016,9.5700000000000000e+02,147410,26402,233,187,174232
2016,9.3900000000000000e+02,137709,19902,22,102,157735
2016,2.3600000000000000e+02,29576,1014,9,0,30599
2016,7.3500000000000000e+02,149138,16675,2483,437,168733
2016,1.4600000000000000e+02,0,0,0,0,0
2016,3.6300000000000000e+02,7227,332,39,1,7599
2016,1.8700000000000000e+02,8901,103,12,0,9016
2016,2.6500000000000000e+02,7610,202,0,0,7812
2016,2.9500000000000000e+02,27522,971,5,0,28498
2016,4.9600000000000000e+02,44882,12070,3704,37,60693
2016,7.7000000000000000e+01,0,0,0,0,0
2016,3.9100000000000000e+02,3611,593,11,0,4215
2016,2.4000000000000000e+02,29800,3079,4070,25,36974
2016,4.4800000000000000e+02,8901,628,192,16,9737
2016,1.5100000000000000e+02,0,0,0,0,0
2016,4.2500000000000000e+02,5792,346,107,13,6258
2016,3.0000000000000000e+02,28204,2293,33,0,30530
2016,3.3900000000000000e+02,26429,1907,123,1,28460
2016,8.7400000000000000e+02,22009,4167,18,62,26256
2016,9.0500000000000000e+02,74424,12571,4086,367,91448
2016,7.3600000000000000e+02,21350,148011,97,320,169778
2016,4.5900000000000000e+02,3649,15,0,0,3664
2016,3.2000000000000000e+02,0,0,0,0,0
2016,4.5000000000000000e+01,0,0,0,0,0
2016,6.1800000000000000e+02,37775,4405,706,46,42932
2016,4.6300000000000000e+02,99648,7837,1200,66,108751
2016,8.9100000000000000e+02,33190,2065,236,2,35493
2016,9.5800000000000000e+02,43919,7458,72,32,51481
2016,2.4400000000000000e+02,10775,434,16,0,11225
2016,2.8000000000000000e+01,0,0,0,0,0
2016,4.4400000000000000e+02,6635,285,70,0,6990
2016,4.7900000000000000e+02,0,0,0,0,0
2016,2.8500000000000000e+02,28642,1836,49,17,30544
2016,2.5300000000000000e+02,82223,2796,16,1,85036
2016,4.8100000000000000e+02,36948,1550,23,1,38522
2016,5.4000000000000000e+02,37336,6002,139,0,43477
2016,3.3200000000000000e+02,0,0,0,0,0
2016,4.1000000000000000e+01,0,0,0,0,0
2016,5.1000000000000000e+02,44559,966,74,0,45599
2016,3.0500000000000000e+02,39050,357,1546,16,40969
2016,7.0800000000000000e+02,63058,5966,484,124,69632
2016,7.5500000000000000e+02,268280,25335,4144,495,298254
2016,7.5000000000000000e+02,187393,22435,1199,238,211265
2016,6.9600000000000000e+02,115353,15499,777,145,131774
2016,4.2100000000000000e+02,18771,939,0,0,19710
2016,8.2700000000000000e+02,0,0,0,0,0
2016,9.3300000000000000e+02,92997,6143,1114,95,100349
2016,1.0300000000000000e+03,108947,4225,94,3,113269
2016,1.0030000000000000e+03,65071,51,2545,15,67682
2016,1.0500000000000000e+03,19361,100,739,10,20210
2016,1.0430000000000000e+03,62616,3204,21,0,65841
2016,1.1280000000000000e+03,53886,560,1558,15,56019
2016,9.3400000000000000e+02,25619,6170,111,28,31928
2016,6.2900000000000000e+02,78220,9646,1477,123,89466
2016,2.1000000000000000e+01,0,0,0,0,0
2016,6.1500000000000000e+02,55819,4529,448,18,60814
2016,6.2600000000000000e+02,15815,523,6,0,16344
2016,4.1700000000000000e+02,7531,0,0,0,7531
2016,5.9700000000000000e+02,16092,2097,220,12,18421
2016,5.3900000000000000e+02,75634,9973,649,74,86330
2016,3.4300000000000000e+02,21867,483,0,11,22361
2016,1.3500000000000000e+02,0,0,0,0,0
2016,1.5800000000000000e+02,3634,895,0,0,4529
2016,7.7500000000000000e+02,36562,7141,490,49,44242
2016,1.7700000000000000e+02,0,0,0,0,0
2016,5.7800000000000000e+02,22048,378,290,0,22716
2016,4.1600000000000000e+02,25898,285,62,0,26245
2016,5.6100000000000000e+02,31613,3349,306,105,35373
2016,6.2000000000000000e+01,0,0,0,0,0
2016,8.2800000000000000e+02,0,0,0,0,0
2016,8.6000000000000000e+02,36999,875,592,12,38478
2016,9.3500000000000000e+02,0,0,0,0,0
2016,9.3600000000000000e+02,0,0,0,0,0
2016,9.8600000000000000e+02,859,176,0,0,1035
2016,9.8700000000000000e+02,68734,3528,1237,83,73582
2016,1.0210000000000000e+03,0,0,0,0,0
2016,1.0850000000000000e+03,0,0,0,0,0
2016,6.5800000000000000e+02,29014,5481,192,17,34704
2016,3.5300000000000000e+02,0,0,0,0,0
2016,3.2300000000000000e+02,0,0,0,0,0
2016,6.2000000000000000e+02,18133,3443,190,9,21775
2016,3.8400000000000000e+02,0,0,0,0,0
2016,5.5400000000000000e+02,61664,7440,121,231,69456
2016,2.0900000000000000e+02,13590,527,0,1,14118
2016,7.0700000000000000e+02,137276,23948,61,101,161386
2016,3.9500000000000000e+02,5581,52,0,0,5633
2016,9.6900000000000000e+02,40367,1061,171,1,41600
2016,1.0520000000000000e+03,0,0,0,0,0
2016,7.3900000000000000e+02,227133,26100,6609,106,259948
2016,6.1300000000000000e+02,109792,17582,674,56,128104
2016,5.9300000000000000e+02,50467,9112,985,53,60617
2016,7.0400000000000000e+02,143885,14703,988,103,159679
2016,4.9300000000000000e+02,0,0,0,0,0
2016,6.8600000000000000e+02,121403,14678,741,76,136898
2016,2.5700000000000000e+02,70115,4304,44,2,74465
2016,4.9400000000000000e+02,0,0,0,0,0
2016,6.8100000000000000e+02,5361,1898,6,2,7267
2016,2.8600000000000000e+02,17232,2144,21339,0,40715
2016,2.5500000000000000e+02,69730,2225,31,0,71986
2016,7.9000000000000000e+01,0,0,0,0,0
2016,8.1000000000000000e+01,0,0,0,0,0
2016,6.8800000000000000e+02,67272,10862,650,63,78847
2016,5.3100000000000000e+02,54153,7879,527,84,62643
2016,5.1400000000000000e+02,24630,1788,543,10,26971
2016,4.9900000000000000e+02,9333,2137,53,0,11523
2016,5.3200000000000000e+02,63982,6770,822,54,71628
2016,1.9000000000000000e+02,0,0,0,0,0
2016,5.9800000000000000e+02,22784,2515,597,54,25950
2016,2.6000000000000000e+02,112464,8152,178,5,120799
2016,8.3800000000000000e+02,15066,320,13,0,15399
2016,8.3900000000000000e+02,7170,31,14,0,7215
2016,8.5100000000000000e+02,0,0,0,0,0
2016,8.5200000000000000e+02,99640,15082,172,105,114999
2016,9.8800000000000000e+02,0,0,0,0,0
2016,1.0560000000000000e+03,96890,10804,233,65,107992
2016,1.0440000000000000e+03,0,0,0,0,0
2016,1.1140000000000000e+03,29706,3278,797,18,33799
2016,6.4400000000000000e+02,99883,15969,286,50,116188
2016,7.5200000000000000e+02,87368,13186,1076,75,101705
2016,2.3800000000000000e+02,14382,913,60,2,15357
2016,3.2500000000000000e+02,0,0,0,0,0
2016,6.2200000000000000e+02,24662,2967,355,19,28003
2016,8.7900000000000000e+02,7820,167,24,0,8011
2016,9.0600000000000000e+02,49264,1360,66,0,50690
2016,3.7000000000000000e+02,1435,4434,59,44,5972
2016,4.1800000000000000e+02,6687,695,28,0,7410
2016,5.7400000000000000e+02,9080,213,0,0,9293
2016,3.9900000000000000e+02,0,0,0,0,0
2016,1.9500000000000000e+02,2917,0,0,0,2917
2016,7.8300000000000000e+02,107159,21192,1256,244,129851
2016,2.6300000000000000e+02,13252,1165,45,0,14462
2016,1.9400000000000000e+02,3556,1,0,0,3557
2016,2.1400000000000000e+02,4016,94,0,0,4110
2016,7.8500000000000000e+02,177581,25739,2464,414,206198
2016,7.8000000000000000e+02,35251,3538,503,24,39316
2016,7.8200000000000000e+02,88501,12623,2740,172,104036
2016,3.6900000000000000e+02,0,0,0,0,0
2016,7.1300000000000000e+02,38255,151,192,247,38845
2016,9.4100000000000000e+02,305,196,13,0,514
2016,1.0910000000000000e+03,0,0,0,0,0
2016,1.0450000000000000e+03,32311,1066,5,0,33382
2016,1.0860000000000000e+03,71041,5267,641,0,76949
2016,9.3700000000000000e+02,58687,12432,450,84,71653
2016,1.0040000000000000e+03,6933,453,157,0,7543
2016,7.3700000000000000e+02,115735,16170,833,85,132823
2016,7.6500000000000000e+02,170395,27759,2069,161,200384
2016,3.2900000000000000e+02,71207,6986,1766,51,80010
2016,8.7000000000000000e+01,0,0,0,0,0
2016,5.2700000000000000e+02,19326,806,535,4,20671
2016,5.6200000000000000e+02,23863,1161,78,1,25103
2016,2.5100000000000000e+02,26923,1499,103,3,28528
2016,1.2900000000000000e+02,0,0,0,0,0
2016,1.5400000000000000e+02,0,0,0,0,0
2016,5.1600000000000000e+02,46136,5290,0,0,51426
2016,1.8400000000000000e+02,12807,2420,340,0,15567
2016,6.5200000000000000e+02,11074,1686,102,0,12862
2016,6.3700000000000000e+02,20626,2991,290,13,23920
2016,8.8000000000000000e+01,0,0,0,0,0
2016,9.0700000000000000e+02,0,0,0,0,0
2016,9.7000000000000000e+02,0,0,0,0,0
2016,1.0190000000000000e+03,1991,480,337,5,2813
2016,1.0160000000000000e+03,51810,932,63,0,52805
2016,1.0470000000000000e+03,66484,5263,17,43,71807
2016,6.3500000000000000e+02,57622,6107,13,38,63780
